# Any line followed by a '#' character is ignored
# Section headings must be in square brackets
# Subsections within a section should follow the format:
#   [filename within code directory][tab character \t][subsection title]

[基礎]
keyword.txt	關鍵字思考
C++_basic.cc	C++ 基礎
C++_remind.txt	C++ 易忘的內建函數
python.py	python 常用

[官-數學]
find_divisor.cc	找因數
GCD.cc	公因數
derivative.cc	求導數
sum_of_product.txt	Sum of Product
Farie_series.txt	法里數列

[立委-幾何]
Center_of_Masses_(Polygon).cc	Center of Masses (Polygon)
convexHull.cc	convexHull
Intersection(Line_and_Line).cc	Intersection(Line and Line)
Intersection(Line_and_Point).cc	Intersection(Line and Point)
Pack_Polygon_Circle.cc	Pack Polygon Circle
Two_Point_and_Circle.cc	Two Point and Circle

[立委-圖論]
Li_Kruskal.cc	Kruskal
Li_Shortest_Path.cc	Shortest Path

[大衛-動態規劃]
01_Knapsack_Problem.cc	背包問題
LCS_ologn.cc	LCS 
LIS.cc	LIS
Josephus_problem.cc	約瑟夫問題

[大衛-圖論]
floyd.cc	floyd 最短路徑
kruskal.cc	最小生成樹
graph_theorm_find_bridge.cc	找圖中的橋 find bridge
Topological_Ordering.cc	拓樸排序
Component_Kosaraju_Algorithm.cc	Component Kosaraju's Algorithm 找出 SCC
Component_Tarjan_Algorithm.cc	Tarjan's Algorithm 找出 ACC
dijkstra.cc	dijkstra
Maximum_Bipartite_Matching.cc	二分匹配、二分圖

[大衛-資料結構]
Disjoint_Set.cc	並查集
segment_tree.cc	線段樹

[大衛-字串]
KMP.cc	KMP
Minimum_Edit_Distance.cc	最短修改距離
Suffix_Automaton.cc	Suffix Automaton
suffix_tree.cc	suffix tree
